date,transition,transition_deputy,parliament_report,parliament_committee,parliament_committee_deputy,total
2025-03-29,85,61,483,431,409,1469
2025-03-28,85,61,483,430,409,1468
2025-03-27,85,61,483,430,409,1468
2025-03-26,85,61,483,430,409,1468
2025-03-25,85,61,483,429,409,1467
2025-03-24,85,61,483,429,409,1467
2025-03-23,85,61,483,429,409,1467
2025-03-22,85,61,483,429,408,1466
2025-03-21,85,60,483,429,408,1465
2025-03-20,85,60,483,428,408,1464
2025-03-19,85,60,483,428,408,1464
2025-03-18,85,60,483,428,408,1464
2025-03-17,85,60,483,428,408,1464
2025-03-16,85,60,483,428,408,1464
2025-03-15,85,60,483,428,408,1464
2025-03-14,85,60,483,428,408,1464
2025-03-13,85,60,483,428,407,1463
2025-03-12,85,60,483,428,407,1463
2025-03-11,85,60,483,428,406,1462
2025-03-10,85,60,483,428,406,1462
2025-03-09,85,60,483,428,406,1462
2025-03-08,85,60,483,428,404,1460
2025-03-07,84,60,483,427,403,1457
2025-03-06,84,60,483,427,403,1457
2025-03-05,83,60,483,427,403,1456
2025-03-04,83,60,483,427,403,1456
2025-03-03,83,60,483,427,403,1456
2025-03-02,83,60,483,427,403,1456
2025-03-01,83,60,483,427,401,1454
2025-02-28,83,60,483,426,401,1453
2025-02-27,83,60,483,426,401,1453
2025-02-26,83,60,483,426,401,1453
2025-02-25,83,60,483,426,401,1453
2025-02-24,83,60,483,426,401,1453
2025-02-23,83,60,483,426,401,1453
2025-02-22,83,60,483,426,401,1453
2025-02-21,83,60,483,425,400,1451
2025-02-20,83,60,482,423,399,1447
2025-02-19,83,60,482,423,399,1447
2025-02-18,83,60,482,423,399,1447
2025-02-17,83,60,482,423,399,1447
2025-02-16,83,60,482,423,399,1447
2025-02-15,83,60,482,422,399,1446
2025-02-14,83,60,482,422,399,1446
2025-02-13,83,60,482,422,399,1446
2025-02-12,83,60,482,422,399,1446
2025-02-11,83,60,482,421,398,1444
2025-02-10,83,60,482,421,398,1444
2025-02-09,83,60,482,421,398,1444
2025-02-08,83,60,482,383,389,1397
2025-02-07,83,60,482,383,388,1396
2025-02-06,83,60,482,381,388,1394
2025-02-05,83,59,481,381,380,1384
2025-02-04,83,59,481,381,380,1384
2025-02-03,83,59,481,381,380,1384
2025-02-02,83,59,481,381,380,1384
2025-02-01,71,59,480,378,379,1367
2025-01-31,71,59,480,378,379,1367
2025-01-30,71,59,480,378,379,1367
2025-01-29,71,59,480,378,379,1367
2025-01-28,71,59,478,377,377,1362
2025-01-27,71,59,478,377,377,1362
2025-01-26,71,59,478,377,377,1362
2025-01-25,71,59,478,377,375,1360
2025-01-24,71,59,478,375,375,1358
2025-01-23,71,59,478,375,375,1358
2025-01-22,71,59,478,375,375,1358
2025-01-21,71,59,478,375,375,1358
2025-01-20,71,59,478,375,375,1358
2025-01-19,71,59,478,375,375,1358
2025-01-18,71,58,478,375,373,1355
2025-01-17,71,58,478,375,373,1355
2025-01-16,71,58,478,375,373,1355
2025-01-15,71,58,476,375,372,1352
2025-01-14,71,58,476,375,372,1352
2025-01-13,71,58,476,375,372,1352
2025-01-12,71,58,476,375,372,1352
2025-01-11,71,58,476,375,371,1351
2025-01-10,71,57,476,375,371,1350
2025-01-09,71,57,476,375,371,1350
2025-01-08,71,57,476,375,371,1350
2025-01-07,71,57,474,375,370,1347
2025-01-06,71,57,474,375,370,1347
2025-01-05,71,57,474,375,370,1347
2025-01-04,71,57,474,375,370,1347
2025-01-03,71,57,474,375,370,1347
2025-01-02,71,57,474,375,370,1347
2025-01-01,71,57,474,375,370,1347
2024-12-31,71,57,474,375,370,1347
2024-12-30,71,57,474,375,370,1347
2024-12-29,71,57,474,375,370,1347
2024-12-28,71,57,474,375,369,1346
2024-12-27,71,57,474,375,369,1346
2024-12-26,71,57,474,375,369,1346
2024-12-25,71,57,473,375,368,1344
2024-12-24,71,57,473,375,368,1344
2024-12-23,71,57,473,375,368,1344
2024-12-22,71,57,473,375,368,1344
2024-12-21,71,57,473,375,368,1344
2024-12-20,71,57,469,375,368,1340
2024-12-19,71,56,464,376,367,1334
2024-12-18,71,56,464,376,367,1334
2024-12-17,71,56,464,376,367,1334
2024-12-16,71,56,464,376,367,1334
2024-12-15,71,56,464,376,367,1334
2024-12-14,71,56,464,376,367,1334
2024-12-13,71,56,464,376,367,1334
2024-12-12,71,56,464,376,367,1334
2024-12-11,71,56,464,376,367,1334
2024-12-10,71,56,464,376,367,1334
2024-12-09,71,56,464,376,367,1334
2024-12-08,71,56,464,376,367,1334
2024-12-07,71,56,464,376,367,1334
2024-12-06,71,56,464,376,366,1333
2024-12-05,71,56,464,376,366,1333
2024-12-04,71,56,461,376,366,1330
2024-12-03,71,56,461,376,366,1330
2024-12-02,71,56,461,376,366,1330
2024-12-01,71,56,461,376,366,1330
2024-11-30,71,56,461,376,366,1330
2024-11-29,71,56,461,376,366,1330
2024-11-28,71,55,461,376,366,1329
2024-11-27,71,55,460,376,366,1328
2024-11-26,71,55,460,376,365,1327
2024-11-25,71,55,460,376,365,1327
2024-11-24,71,55,460,376,365,1327
2024-11-23,71,55,460,375,363,1324
2024-11-22,71,55,460,375,363,1324
2024-11-21,71,55,457,375,362,1320
2024-11-20,71,55,457,375,362,1320
2024-11-19,71,55,457,381,352,1316
2024-11-18,71,55,457,381,352,1316
2024-11-17,71,55,457,381,352,1316
2024-11-16,71,55,457,381,352,1316
2024-11-15,71,55,457,381,352,1316
2024-11-14,71,55,457,381,352,1316
2024-11-13,71,55,456,381,352,1315
2024-11-12,71,55,456,381,352,1315
2024-11-11,71,55,456,381,352,1315
2024-11-10,71,55,456,381,352,1315
2024-11-09,71,55,455,381,352,1314
2024-11-08,71,55,451,381,352,1310
2024-11-07,71,55,448,381,352,1307
2024-11-06,71,55,445,381,352,1304
2024-11-05,71,55,445,381,352,1304
2024-11-04,71,55,445,381,352,1304
2024-11-03,71,55,445,381,352,1304
2024-11-02,71,55,445,381,352,1304
2024-11-01,71,55,444,381,352,1303
2024-10-31,71,55,444,381,352,1303
2024-10-30,71,55,441,381,352,1300
2024-10-29,71,53,436,381,352,1293
2024-10-28,71,53,436,381,352,1293
2024-10-27,71,53,436,381,352,1293
2024-10-26,71,53,436,381,352,1293
2024-10-25,71,53,433,381,352,1290
2024-10-24,71,53,433,381,352,1290
2024-10-23,71,53,429,381,352,1286
2024-10-22,71,53,428,381,352,1285
2024-10-21,71,53,428,381,352,1285
2024-10-20,71,53,428,381,352,1285
2024-10-19,71,53,426,381,352,1283
2024-10-18,71,53,426,381,351,1282
2024-10-17,71,53,426,378,351,1279
2024-10-16,71,53,426,330,348,1228
2024-10-15,71,53,426,330,348,1228
2024-10-14,71,53,426,330,348,1228
2024-10-13,71,53,426,330,348,1228
2024-10-12,71,53,426,330,346,1226
2024-10-11,71,53,422,330,346,1222
2024-10-10,71,53,421,330,346,1221
2024-10-09,71,53,415,330,346,1215
2024-10-08,71,53,415,329,346,1214
2024-10-07,71,53,415,329,346,1214
2024-10-06,71,53,415,329,346,1214
2024-10-05,71,53,413,329,346,1212
2024-10-04,71,53,413,329,346,1212
2024-10-03,71,53,412,331,335,1202
2024-10-02,71,53,412,331,334,1201
2024-10-01,71,53,412,331,334,1201
2024-09-30,71,53,412,331,334,1201
2024-09-29,71,53,412,331,334,1201
2024-09-28,71,53,412,327,330,1193
2024-09-27,71,53,412,325,330,1191
2024-09-26,71,53,412,325,330,1191
2024-09-25,71,54,412,325,330,1192
2024-09-24,71,54,412,325,330,1192
2024-09-23,71,54,412,325,330,1192
2024-09-22,71,54,412,325,330,1192
2024-09-21,71,54,411,324,330,1190
2024-09-20,71,54,411,322,330,1188
2024-09-19,71,54,411,322,328,1186
2024-09-18,71,54,411,322,328,1186
2024-09-17,71,54,411,322,328,1186
2024-09-16,71,54,411,322,328,1186
2024-09-15,71,54,411,322,328,1186
2024-09-14,71,54,411,320,325,1181
2024-09-13,71,54,411,320,325,1181
2024-09-12,71,54,411,320,325,1181
2024-09-11,71,54,411,320,325,1181
2024-09-10,71,54,411,320,325,1181
2024-09-09,71,54,411,320,325,1181
2024-09-08,71,54,411,320,325,1181
2024-09-07,71,54,411,320,325,1181
2024-09-06,71,53,411,319,324,1178
2024-09-05,71,53,411,318,324,1177
2024-09-04,71,53,411,318,324,1177
2024-09-03,71,53,411,318,324,1177
2024-09-02,71,53,411,318,324,1177
2024-09-01,71,53,411,318,324,1177
2024-08-31,71,53,411,318,323,1176
2024-08-30,71,52,411,317,322,1173
2024-08-29,71,52,411,317,322,1173
2024-08-28,71,52,411,316,322,1172
2024-08-27,71,52,411,316,322,1172
2024-08-26,71,52,411,316,322,1172
2024-08-25,71,52,411,316,322,1172
2024-08-24,71,52,411,316,322,1172
2024-08-23,71,52,411,316,322,1172
2024-08-22,71,52,411,315,320,1169
2024-08-21,71,52,411,315,320,1169
2024-08-20,71,52,411,311,318,1163
2024-08-19,71,52,411,311,318,1163
2024-08-18,71,52,411,311,318,1163
2024-08-17,71,52,411,311,318,1163
2024-08-16,71,52,411,311,316,1161
2024-08-15,71,52,411,311,316,1161
2024-08-14,71,52,411,311,316,1161
2024-08-13,71,52,411,311,316,1161
2024-08-12,71,52,411,311,316,1161
2024-08-11,71,52,411,311,316,1161
2024-08-10,71,52,411,311,316,1161
2024-08-09,71,52,411,311,316,1161
2024-08-08,71,52,410,311,315,1159
2024-08-07,71,52,410,311,315,1159
2024-08-06,71,52,410,311,315,1159
2024-08-05,71,52,410,311,315,1159
2024-08-04,71,52,410,311,315,1159
2024-08-03,71,52,410,311,315,1159
2024-08-02,71,52,410,310,315,1158
2024-08-01,71,52,410,309,314,1156
2024-07-31,71,52,410,309,314,1156
2024-07-30,71,52,410,309,312,1154
2024-07-29,71,52,410,309,312,1154
2024-07-28,71,52,410,309,312,1154
2024-07-27,71,52,410,309,312,1154
2024-07-26,71,52,410,309,312,1154
2024-07-25,71,52,410,309,311,1153
2024-07-24,71,52,410,309,309,1151
2024-07-23,71,52,409,309,309,1150
2024-07-22,71,52,409,309,309,1150
2024-07-21,71,52,409,309,309,1150
2024-07-20,71,52,409,306,308,1146
2024-07-19,71,52,409,306,308,1146
2024-07-18,71,52,409,306,308,1146
2024-07-17,71,52,409,305,308,1145
2024-07-16,71,52,409,305,306,1143
2024-07-15,70,52,409,305,306,1142
2024-07-14,70,52,409,305,306,1142
2024-07-13,70,52,408,305,302,1137
2024-07-12,70,52,408,303,298,1131
2024-07-11,70,52,408,298,298,1126
2024-07-10,70,52,408,298,298,1126
2024-07-09,70,52,408,298,298,1126
2024-07-08,70,52,408,298,297,1125
2024-07-07,70,52,408,298,297,1125
2024-07-06,70,52,408,298,297,1125
2024-07-05,70,52,408,298,297,1125
2024-07-04,70,52,408,298,297,1125
2024-07-03,70,52,408,298,296,1124
2024-07-02,70,52,408,298,296,1124
2024-07-01,70,52,408,298,296,1124
2024-06-30,70,52,408,298,296,1124
2024-06-29,70,52,408,298,296,1124
2024-06-28,70,52,408,298,293,1121
2024-06-27,70,52,408,298,293,1121
2024-06-26,70,52,408,298,293,1121
2024-06-25,70,52,408,298,293,1121
2024-06-24,70,52,408,298,293,1121
2024-06-23,70,52,408,298,293,1121
2024-06-22,70,52,406,297,293,1118
2024-06-21,70,52,403,297,293,1115
2024-06-20,70,52,403,296,293,1114
2024-06-19,70,52,402,295,290,1109
2024-06-18,70,52,402,295,290,1109
2024-06-17,70,52,402,295,290,1109
2024-06-16,70,52,402,295,290,1109
2024-06-15,70,52,402,295,289,1108
2024-06-14,70,51,402,293,288,1104
2024-06-13,70,51,402,293,288,1104
2024-06-12,70,51,401,291,288,1101
2024-06-11,70,51,401,291,288,1101
2024-06-10,70,51,401,291,288,1101
2024-06-09,70,51,401,291,288,1101
2024-06-08,70,51,401,291,288,1101
2024-06-07,70,51,401,289,286,1097
2024-06-06,70,51,401,287,285,1094
2024-06-05,70,51,401,287,285,1094
2024-06-04,70,51,401,287,285,1094
2024-06-03,70,51,401,287,285,1094
2024-06-02,70,51,401,287,285,1094
2024-06-01,71,51,401,287,285,1095
2024-05-31,70,51,400,286,285,1092
2024-05-30,70,51,400,285,285,1091
2024-05-29,70,51,400,285,284,1090
2024-05-28,70,51,400,284,284,1089
2024-05-27,70,51,400,284,284,1089
2024-05-26,70,51,400,284,284,1089
2024-05-25,70,51,400,284,283,1088
2024-05-24,70,51,400,284,283,1088
2024-05-23,70,51,399,284,283,1087
2024-05-22,70,51,399,284,283,1087
2024-05-21,70,51,399,284,283,1087
2024-05-20,70,51,399,284,283,1087
2024-05-19,70,51,399,284,283,1087
2024-05-18,70,51,399,284,283,1087
2024-05-17,70,51,397,284,283,1085
2024-05-16,70,50,397,284,283,1084
2024-05-15,70,50,397,284,283,1084
2024-05-14,70,50,397,284,283,1084
2024-05-13,70,50,397,284,283,1084
2024-05-12,70,50,397,284,283,1084
2024-05-11,70,49,397,284,283,1083
2024-05-10,70,49,397,284,283,1083
2024-05-09,70,49,397,284,277,1077
2024-05-08,70,49,397,284,277,1077
2024-05-07,70,49,397,284,276,1076
2024-05-06,70,49,397,284,276,1076
2024-05-05,70,49,397,284,276,1076
2024-05-04,70,49,397,284,276,1076
2024-05-03,70,49,397,284,276,1076
2024-05-02,70,49,397,284,276,1076
2024-05-01,70,49,397,284,276,1076
2024-04-30,70,49,397,284,276,1076
2024-04-29,70,49,397,284,276,1076
2024-04-28,70,49,397,284,276,1076
2024-04-27,70,49,397,284,276,1076
2024-04-26,70,49,397,284,276,1076
2024-04-25,70,49,397,284,276,1076
2024-04-24,70,49,393,284,276,1072
2024-04-23,70,49,393,284,276,1072
2024-04-20,70,49,389,284,276,1068
2024-04-19,70,49,388,284,276,1067
2024-04-18,70,49,388,284,276,1067
2024-04-17,70,49,386,284,276,1065
2024-04-16,70,49,386,284,276,1065
2024-04-15,70,49,386,284,276,1065
2024-04-14,70,49,386,284,276,1065
2024-04-12,70,49,386,284,276,1065
2024-04-11,70,49,385,283,273,1060
2024-04-10,70,49,385,283,273,1060
2024-04-09,70,49,382,282,273,1056
2024-04-07,70,49,382,282,273,1056
2024-04-06,70,49,382,281,273,1055
2024-04-05,70,49,382,281,273,1055
2024-04-04,70,49,382,281,271,1053
2024-04-03,70,49,382,281,271,1053
2024-04-02,70,49,382,281,271,1053
2024-04-01,70,49,382,281,271,1053
2024-03-31,70,49,382,281,271,1053
2024-03-30,70,49,382,281,271,1053
2024-03-29,70,48,382,280,271,1051
2024-03-28,70,48,382,280,270,1050
2024-03-27,70,48,382,279,270,1049
2024-03-26,70,48,382,279,270,1049
2024-03-25,70,48,382,279,270,1049
2024-03-24,70,48,382,279,270,1049
2024-03-23,70,48,381,279,269,1047
2024-03-22,70,48,379,279,262,1038
2024-03-21,70,48,379,279,262,1038
2024-03-20,70,48,379,279,262,1038
2024-03-19,70,48,379,279,261,1037
2024-03-18,70,48,379,279,261,1037
2024-03-17,70,48,379,279,261,1037
2024-03-16,70,48,379,279,257,1033
2024-03-15,70,48,379,279,257,1033
2024-03-14,70,48,379,279,257,1033
2024-03-13,70,48,378,279,255,1030
2024-03-12,69,48,378,279,253,1027
2024-03-11,69,48,378,279,253,1027
2024-03-10,69,48,378,279,253,1027
2024-03-09,69,48,378,279,250,1024
2024-03-08,69,48,378,279,250,1024
2024-03-07,69,48,378,279,250,1024
2024-03-06,69,48,376,279,250,1022
2024-03-05,69,48,376,279,250,1022
2024-03-04,69,48,376,279,250,1022
2024-03-03,69,48,376,279,250,1022
2024-03-02,69,48,376,279,249,1021
2024-03-01,69,48,374,279,249,1019
2024-02-29,69,48,374,279,248,1018
2024-02-28,69,48,374,279,248,1018
2024-02-27,69,48,374,278,244,1013
2024-02-26,69,48,374,278,244,1013
2024-02-25,69,48,374,278,244,1013
2024-02-24,69,48,373,275,243,1008
2024-02-23,69,48,372,274,243,1006
2024-02-22,69,48,372,274,243,1006
2024-02-21,69,48,372,274,243,1006
2024-02-20,69,48,372,274,242,1005
2024-02-19,69,48,372,274,242,1005
2024-02-18,69,48,372,274,242,1005
2024-02-17,69,48,371,273,242,1003
2024-02-16,69,48,371,273,242,1003
2024-02-15,69,48,371,273,242,1003
2024-02-14,69,48,371,273,242,1003
2024-02-13,69,48,371,273,242,1003
2024-02-12,69,48,371,273,242,1003
2024-02-11,69,48,371,273,242,1003
2024-02-10,69,47,371,273,242,1002
2024-02-09,69,47,371,273,242,1002
2024-02-08,69,47,371,272,242,1001
2024-02-07,69,47,371,272,242,1001
2024-02-06,69,47,371,272,242,1001
2024-02-05,69,47,371,272,242,1001
2024-02-04,69,47,371,272,242,1001
2024-02-03,69,47,371,272,242,1001
2024-02-02,69,47,371,272,241,1000
2024-02-01,69,47,371,272,241,1000
2024-01-31,69,47,371,272,241,1000
2024-01-30,69,47,370,271,241,998
2024-01-28,69,47,370,271,241,998
2024-01-27,69,47,370,271,241,998
2024-01-26,69,47,370,271,240,997
2024-01-25,69,47,370,271,240,997
2024-01-24,69,47,370,271,240,997
2024-01-23,69,47,370,271,240,997
2024-01-22,69,47,370,271,240,997
2024-01-21,69,47,370,271,240,997
2024-01-20,69,47,370,271,235,992
2024-01-19,69,47,370,270,235,991
2024-01-18,69,47,370,268,235,989
2024-01-17,69,47,369,267,235,987
2024-01-16,69,47,369,267,233,985
2024-01-15,69,47,369,267,233,985
2024-01-14,69,47,369,267,233,985
2024-01-13,69,47,369,267,233,985
2024-01-12,69,47,369,267,233,985
2024-01-11,69,47,369,267,233,985
2024-01-10,69,47,369,267,233,985
2024-01-09,69,46,369,267,233,984
2024-01-08,69,46,369,267,233,984
2024-01-07,69,46,369,267,233,984
2024-01-06,69,46,369,267,233,984
2024-01-05,69,46,369,267,233,984
2024-01-04,69,46,370,267,233,985
2024-01-03,69,46,370,267,233,985
2024-01-02,69,46,370,267,233,985
2024-01-01,69,46,370,267,233,985
2023-12-31,69,46,370,267,233,985
2023-12-30,69,46,370,267,233,985
2023-12-29,69,46,370,267,233,985
2023-12-28,69,46,369,267,233,984
2023-12-27,69,46,369,267,233,984
2023-12-26,69,46,369,267,233,984
2023-12-25,69,46,369,267,233,984
2023-12-24,69,46,369,267,233,984
2023-12-23,69,46,369,267,231,982
2023-12-22,69,46,369,267,231,982
2023-12-21,69,46,369,267,230,981
2023-12-20,69,46,369,267,230,981
2023-12-19,69,46,369,267,230,981
2023-12-18,69,46,369,267,230,981
2023-12-17,69,46,369,267,230,981
2023-12-16,69,46,368,267,228,978
2023-12-15,69,46,368,267,228,978
2023-12-14,69,46,368,267,227,977
2023-12-13,69,46,355,267,227,964
2023-12-12,69,46,355,267,227,964
2023-12-11,69,46,355,267,227,964
2023-12-10,69,46,355,267,227,964
2023-12-09,69,46,355,267,227,964
2023-12-08,69,46,353,267,227,962
2023-12-07,69,46,353,267,227,962
2023-12-06,69,46,352,267,227,961
2023-12-05,69,46,352,267,227,961
2023-12-04,69,46,350,266,227,958
2023-12-03,69,46,350,266,227,958
2023-12-02,69,46,347,266,226,954
2023-12-01,69,46,348,266,226,955
2023-11-30,69,46,346,266,226,953
2023-11-29,69,46,346,265,226,952
2023-11-28,69,46,346,265,226,952
2023-11-27,69,46,346,265,226,952
2023-11-26,69,46,346,265,226,952
2023-11-24,66,46,345,265,226,948
2023-11-23,63,46,344,265,226,944
2023-11-22,63,45,343,265,226,942
2023-11-21,62,45,342,265,226,940
2023-11-20,62,45,342,265,226,940
2023-11-19,62,45,342,265,226,940
2023-11-18,62,45,337,265,226,935
2023-11-17,62,45,335,265,226,933
2023-11-16,62,45,331,265,226,929
2023-11-15,62,45,331,265,226,929
2023-11-14,62,45,331,265,226,929
2023-11-13,62,45,331,265,226,929
2023-11-12,62,45,331,265,226,929
2023-11-11,62,45,331,265,226,929
2023-11-10,61,45,329,265,226,926
2023-11-09,61,45,329,265,226,926
